20 12
100 100
3 3 3 3 3 3 3 3 3 3 3 3 3 3 3 3 3 3 3 3
3 3 3 3 3 3 3 3 3 3 3 3 3 3 3 3 3 3 3 3
3 3 3 3 3 3 3 3 3 3 3 3 3 3 3 3 3 3 3 3
3 3 3 3 3 3 3 3 3 3 3 3 3 3 3 3 3 3 3 3
3 3 3 3 3 3 3 3 3 3 3 3 3 3 3 3 3 3 3 3
3 3 3 3 3 3 3 3 3 3 3 3 3 3 3 3 3 3 3 3
0 0 0 4 0 3 3 3 3 3 3 3 3 3 3 3 3 3 3 3
2 2 2 2 2 0 3 3 0 0 0 0 0 0 1 3 3 3 3 3
2 2 2 2 2 2 0 3 2 2 2 2 2 2 2 3 3 3 3 3 
2 3 2 2 2 3 3 3 3 2 2 2 2 3 3 3 3 3 3 3
3 3 3 2 3 3 3 0 3 3 2 2 3 3 3 3 3 3 3 3
3 3 3 2 3 3 3 3 3 3 3 3 3 3 3 3 3 3 3 3
